{
  "SegoeUI-Semibold": {
    "099a": "1",
    "0999": "0",
    "099f": "6",
    "099b": "2",
    "099c": "3",
    "09a1": "8",
    "099e": "5"
  }
}
